Mesorregião,Município,Administração_Pública,Agricultura,Comércio,Industria,Serviços,Total
SÃO JOSÉ DO RIO PRETO,APARECIDA D'OESTE,248,102,105,166,73,694
SÃO JOSÉ DO RIO PRETO,ASPÁSIA,173,20,14,2,9,218
SÃO JOSÉ DO RIO PRETO,DIRCE REIS,150,9,14,120,4,297
SÃO JOSÉ DO RIO PRETO,DOLCINÓPOLIS,163,16,22,71,17,289
SÃO JOSÉ DO RIO PRETO,JALES,1366,152,4261,2510,3627,11916
SÃO JOSÉ DO RIO PRETO,MARINÓPOLIS,161,81,38,1,7,288
SÃO JOSÉ DO RIO PRETO,MESÓPOLIS,182,45,23,2,1,253
SÃO JOSÉ DO RIO PRETO,NOVA CANAÃ PAULISTA,161,20,18,2,10,211
SÃO JOSÉ DO RIO PRETO,PALMEIRA D'OESTE,310,180,379,73,203,1145
SÃO JOSÉ DO RIO PRETO,PARANAPUÃ,164,404,113,4,39,724
SÃO JOSÉ DO RIO PRETO,PONTALINDA,228,55,39,4,14,340
SÃO JOSÉ DO RIO PRETO,POPULINA,217,148,57,3,32,457
SÃO JOSÉ DO RIO PRETO,RUBINÉIA,254,190,66,13,56,579
SÃO JOSÉ DO RIO PRETO,SANTA ALBERTINA,318,1005,203,249,130,1905
SÃO JOSÉ DO RIO PRETO,SANTA CLARA D'OESTE,192,202,26,145,240,805
SÃO JOSÉ DO RIO PRETO,SANTA FÉ DO SUL,1319,331,2366,2153,2702,8871
SÃO JOSÉ DO RIO PRETO,SANTANA DA PONTE PENSA,147,28,14,0,18,207
SÃO JOSÉ DO RIO PRETO,SANTA RITA D'OESTE,205,46,51,5,24,331
SÃO JOSÉ DO RIO PRETO,SANTA SALETE,146,24,39,1,8,218
SÃO JOSÉ DO RIO PRETO,SÃO FRANCISCO,134,12,27,2,8,183
SÃO JOSÉ DO RIO PRETO,TRÊS FRONTEIRAS,234,89,142,67,61,593
SÃO JOSÉ DO RIO PRETO,URÂNIA,302,66,250,499,294,1411
SÃO JOSÉ DO RIO PRETO,VITÓRIA BRASIL,118,21,61,0,5,205
SÃO JOSÉ DO RIO PRETO,ESTRELA D'OESTE,332,249,318,2149,546,3594
SÃO JOSÉ DO RIO PRETO,FERNANDÓPOLIS,1821,524,5366,3608,5094,16413
SÃO JOSÉ DO RIO PRETO,GUARANI D'OESTE,173,18,67,63,16,337
SÃO JOSÉ DO RIO PRETO,INDIAPORÃ,241,66,112,27,88,534
SÃO JOSÉ DO RIO PRETO,MACEDÔNIA,250,124,34,72,30,510
SÃO JOSÉ DO RIO PRETO,MERIDIANO,210,99,96,1510,20,1935
SÃO JOSÉ DO RIO PRETO,MIRA ESTRELA,251,64,53,37,33,438
SÃO JOSÉ DO RIO PRETO,OUROESTE,553,329,427,920,244,2473
SÃO JOSÉ DO RIO PRETO,PEDRANÓPOLIS,210,83,16,77,22,408
SÃO JOSÉ DO RIO PRETO,SÃO JOÃO DAS DUAS PONTES,176,42,36,19,13,286
SÃO JOSÉ DO RIO PRETO,TURMALINA,177,91,28,2,15,313
SÃO JOSÉ DO RIO PRETO,ÁLVARES FLORENCE,267,118,30,49,40,504
SÃO JOSÉ DO RIO PRETO,AMÉRICO DE CAMPOS,312,81,107,31,41,572
SÃO JOSÉ DO RIO PRETO,CARDOSO,466,330,283,83,268,1430
SÃO JOSÉ DO RIO PRETO,COSMORAMA,394,168,196,1706,206,2670
SÃO JOSÉ DO RIO PRETO,PARISI,194,46,18,62,11,331
SÃO JOSÉ DO RIO PRETO,PONTES GESTAL,148,35,33,269,9,494
SÃO JOSÉ DO RIO PRETO,RIOLÂNDIA,499,231,174,27,146,1077
SÃO JOSÉ DO RIO PRETO,VALENTIM GENTIL,449,111,399,2202,226,3387
SÃO JOSÉ DO RIO PRETO,VOTUPORANGA,2384,209,6733,8000,8932,26258
SÃO JOSÉ DO RIO PRETO,ADOLFO,250,280,96,149,117,892
SÃO JOSÉ DO RIO PRETO,ALTAIR,216,450,43,28,23,760
SÃO JOSÉ DO RIO PRETO,BADY BASSITT,680,99,946,1578,1520,4823
SÃO JOSÉ DO RIO PRETO,BÁLSAMO,277,109,297,1478,283,2444
SÃO JOSÉ DO RIO PRETO,CEDRAL,356,137,638,1202,2696,5029
SÃO JOSÉ DO RIO PRETO,GUAPIAÇU,563,702,709,2708,559,5241
SÃO JOSÉ DO RIO PRETO,GUARACI,665,284,266,1140,293,2648
SÃO JOSÉ DO RIO PRETO,IBIRÁ,358,155,444,842,485,2284
SÃO JOSÉ DO RIO PRETO,ICÉM,428,111,99,230,251,1119
SÃO JOSÉ DO RIO PRETO,IPIGUÁ,222,321,108,488,98,1237
SÃO JOSÉ DO RIO PRETO,JACI,226,97,264,1702,854,3143
SÃO JOSÉ DO RIO PRETO,JOSÉ BONIFÁCIO,956,658,2239,3416,2127,9396
SÃO JOSÉ DO RIO PRETO,MENDONÇA,330,1153,217,579,111,2390
SÃO JOSÉ DO RIO PRETO,MIRASSOL,1224,184,3835,7201,3803,16247
SÃO JOSÉ DO RIO PRETO,MIRASSOLÂNDIA,209,238,74,418,103,1042
SÃO JOSÉ DO RIO PRETO,NOVA ALIANÇA,284,96,202,1018,69,1669
SÃO JOSÉ DO RIO PRETO,NOVA GRANADA,541,523,814,342,683,2903
SÃO JOSÉ DO RIO PRETO,OLÍMPIA,1498,530,3590,5353,5964,16935
SÃO JOSÉ DO RIO PRETO,ONDA VERDE,277,439,146,1415,88,2365
SÃO JOSÉ DO RIO PRETO,ORINDIÚVA,343,302,131,2109,292,3177
SÃO JOSÉ DO RIO PRETO,PALESTINA,387,1316,295,581,118,2697
SÃO JOSÉ DO RIO PRETO,PAULO DE FARIA,373,245,106,49,204,977
SÃO JOSÉ DO RIO PRETO,PLANALTO,328,1578,62,310,46,2324
SÃO JOSÉ DO RIO PRETO,POTIRENDABA,580,126,586,2490,820,4602
SÃO JOSÉ DO RIO PRETO,SÃO JOSÉ DO RIO PRETO,6225,604,39564,27634,66487,140514
SÃO JOSÉ DO RIO PRETO,TANABI,672,268,1038,2650,910,5538
SÃO JOSÉ DO RIO PRETO,UBARANA,291,120,104,816,31,1362
SÃO JOSÉ DO RIO PRETO,UCHOA,385,103,240,480,180,1388
SÃO JOSÉ DO RIO PRETO,ZACARIAS,245,217,37,112,37,648
SÃO JOSÉ DO RIO PRETO,ARIRANHA,419,433,199,1452,172,2675
SÃO JOSÉ DO RIO PRETO,CAJOBI,581,371,243,94,251,1540
SÃO JOSÉ DO RIO PRETO,CATANDUVA,2665,705,9298,10882,15996,39546
SÃO JOSÉ DO RIO PRETO,CATIGUÁ,237,132,208,15,105,697
SÃO JOSÉ DO RIO PRETO,ELISIÁRIO,181,156,65,36,55,493
SÃO JOSÉ DO RIO PRETO,EMBAÚBA,213,34,42,55,7,351
SÃO JOSÉ DO RIO PRETO,NOVAIS,226,80,22,11,42,381
SÃO JOSÉ DO RIO PRETO,PALMARES PAULISTA,342,67,204,36,101,750
SÃO JOSÉ DO RIO PRETO,PARAÍSO,287,91,153,1183,96,1810
SÃO JOSÉ DO RIO PRETO,PINDORAMA,572,161,528,957,308,2526
SÃO JOSÉ DO RIO PRETO,SANTA ADÉLIA,595,2218,746,56,573,4188
SÃO JOSÉ DO RIO PRETO,SEVERÍNIA,588,422,445,647,309,2411
SÃO JOSÉ DO RIO PRETO,TABAPUÃ,470,392,462,198,585,2107
SÃO JOSÉ DO RIO PRETO,AURIFLAMA,359,155,763,866,481,2624
SÃO JOSÉ DO RIO PRETO,FLOREAL,190,35,70,110,29,434
SÃO JOSÉ DO RIO PRETO,GASTÃO VIDIGAL,153,48,69,19,23,312
SÃO JOSÉ DO RIO PRETO,GENERAL SALGADO,371,305,339,86,317,1418
SÃO JOSÉ DO RIO PRETO,GUZOLÂNDIA,215,151,52,131,25,574
SÃO JOSÉ DO RIO PRETO,MAGDA,191,193,66,117,71,638
SÃO JOSÉ DO RIO PRETO,NOVA CASTILHO,4,43,14,6,4,71
SÃO JOSÉ DO RIO PRETO,NOVA LUZITÂNIA,161,12,34,2,40,249
SÃO JOSÉ DO RIO PRETO,SÃO JOÃO DE IRACEMA,166,48,20,0,5,239
SÃO JOSÉ DO RIO PRETO,MACAUBAL,266,80,209,190,908,1653
SÃO JOSÉ DO RIO PRETO,MONÇÕES,220,102,40,82,194,638
SÃO JOSÉ DO RIO PRETO,MONTE APRAZÍVEL,644,271,911,1317,1018,4161
SÃO JOSÉ DO RIO PRETO,NEVES PAULISTA,278,140,292,732,189,1631
SÃO JOSÉ DO RIO PRETO,NHANDEARA,344,175,418,236,516,1689
SÃO JOSÉ DO RIO PRETO,NIPOÃ,178,42,85,96,94,495
SÃO JOSÉ DO RIO PRETO,POLONI,219,160,100,274,543,1296
SÃO JOSÉ DO RIO PRETO,SEBASTIANÓPOLIS DO SUL,274,42,70,1701,75,2162
SÃO JOSÉ DO RIO PRETO,UNIÃO PAULISTA,147,27,13,84,23,294
SÃO JOSÉ DO RIO PRETO,IRAPUÃ,286,216,232,178,136,1048
SÃO JOSÉ DO RIO PRETO,ITAJOBI,588,415,980,1606,413,4002
SÃO JOSÉ DO RIO PRETO,MARAPOAMA,225,195,267,1027,47,1761
SÃO JOSÉ DO RIO PRETO,NOVO HORIZONTE,999,2770,2062,1836,1882,9549
SÃO JOSÉ DO RIO PRETO,SALES,292,75,160,178,186,891
SÃO JOSÉ DO RIO PRETO,URUPÊS,408,395,672,822,657,2954
RIBEIRÃO PRETO,BARRETOS,3352,2057,7226,7930,13312,33877
RIBEIRÃO PRETO,COLINA,970,497,610,2717,1286,6080
RIBEIRÃO PRETO,COLÔMBIA,545,2375,132,750,89,3891
RIBEIRÃO PRETO,GUAÍRA,1303,661,2034,7587,2471,14056
RIBEIRÃO PRETO,IPUÃ,718,530,573,514,367,2702
RIBEIRÃO PRETO,JABORANDI,389,208,126,30,82,835
RIBEIRÃO PRETO,MIGUELÓPOLIS,792,300,702,281,701,2776
RIBEIRÃO PRETO,MORRO AGUDO,995,956,1012,3228,1247,7438
RIBEIRÃO PRETO,NUPORANGA,354,403,228,2012,454,3451
RIBEIRÃO PRETO,ORLÂNDIA,1152,996,2500,5233,3119,13000
RIBEIRÃO PRETO,SALES OLIVEIRA,370,567,381,939,470,2727
RIBEIRÃO PRETO,SÃO JOAQUIM DA BARRA,1074,249,2473,6614,2471,12881
RIBEIRÃO PRETO,ARAMINA,298,116,171,4,129,718
RIBEIRÃO PRETO,BURITIZAL,248,129,49,1068,39,1533
RIBEIRÃO PRETO,GUARÁ,867,140,934,837,581,3359
RIBEIRÃO PRETO,IGARAPAVA,738,424,1388,1848,1150,5548
RIBEIRÃO PRETO,ITUVERAVA,1165,387,2216,1227,2474,7469
RIBEIRÃO PRETO,CRISTAIS PAULISTA,278,759,209,329,128,1703
RIBEIRÃO PRETO,FRANCA,4682,1057,26369,27340,28478,87926
RIBEIRÃO PRETO,ITIRAPUÃ,218,300,84,37,37,676
RIBEIRÃO PRETO,JERIQUARA,249,263,41,83,34,670
RIBEIRÃO PRETO,PATROCÍNIO PAULISTA,433,649,345,2558,612,4597
RIBEIRÃO PRETO,PEDREGULHO,537,1258,475,574,485,3329
RIBEIRÃO PRETO,RESTINGA,310,460,80,532,140,1522
RIBEIRÃO PRETO,RIBEIRÃO CORRENTE,247,305,69,97,26,744
RIBEIRÃO PRETO,RIFAINA,241,169,62,453,209,1134
RIBEIRÃO PRETO,SÃO JOSÉ DA BELA VISTA,397,195,150,3,64,809
RIBEIRÃO PRETO,BEBEDOURO,2407,7256,7403,3523,7339,27928
RIBEIRÃO PRETO,CÂNDIDO RODRIGUES,225,138,106,166,25,660
RIBEIRÃO PRETO,FERNANDO PRESTES,316,257,283,397,271,1524
RIBEIRÃO PRETO,GUARIBA,1243,260,1605,3111,1247,7466
RIBEIRÃO PRETO,JABOTICABAL,1864,727,4518,7626,7802,22537
RIBEIRÃO PRETO,MONTE ALTO,1465,505,3275,5843,2551,13639
RIBEIRÃO PRETO,MONTE AZUL PAULISTA,770,1987,1369,744,719,5589
RIBEIRÃO PRETO,PIRANGI,312,354,484,702,495,2347
RIBEIRÃO PRETO,PITANGUEIRAS,966,784,1218,4006,1089,8063
RIBEIRÃO PRETO,SANTA ERNESTINA,288,23,102,11,63,487
RIBEIRÃO PRETO,TAIAÇU,235,127,171,6,77,616
RIBEIRÃO PRETO,TAIÚVA,257,114,184,74,89,718
RIBEIRÃO PRETO,TAQUARAL,229,203,48,25,33,538
RIBEIRÃO PRETO,TAQUARITINGA,1730,1110,2938,2615,2688,11081
RIBEIRÃO PRETO,TERRA ROXA,416,175,237,191,164,1183
RIBEIRÃO PRETO,VIRADOURO,711,211,675,953,637,3187
RIBEIRÃO PRETO,VISTA ALEGRE DO ALTO,218,457,473,2063,210,3421
RIBEIRÃO PRETO,BARRINHA,1035,74,1286,1594,651,4640
RIBEIRÃO PRETO,BRODOWSKI,1120,246,1820,1614,999,5799
RIBEIRÃO PRETO,CRAVINHOS,990,830,1829,5026,1958,10633
RIBEIRÃO PRETO,DUMONT,299,536,294,861,165,2155
RIBEIRÃO PRETO,GUATAPARÁ,397,157,169,229,478,1430
RIBEIRÃO PRETO,JARDINÓPOLIS,1423,960,2291,2908,1796,9378
RIBEIRÃO PRETO,LUÍS ANTÔNIO,638,3216,328,1288,859,6329
RIBEIRÃO PRETO,PONTAL,978,589,1119,5439,1708,9833
RIBEIRÃO PRETO,PRADÓPOLIS,683,12,622,5309,1166,7792
RIBEIRÃO PRETO,RIBEIRÃO PRETO,9925,975,63229,35274,123877,233280
RIBEIRÃO PRETO,SANTA RITA DO PASSA QUATRO,762,453,1259,1675,4168,8317
RIBEIRÃO PRETO,SANTA ROSA DE VITERBO,751,126,1083,1382,1011,4353
RIBEIRÃO PRETO,SÃO SIMÃO,506,481,494,1098,751,3330
RIBEIRÃO PRETO,SERRA AZUL,331,69,186,88,135,809
RIBEIRÃO PRETO,SERRANA,1300,216,1354,2751,1647,7268
RIBEIRÃO PRETO,SERTÃOZINHO,2500,483,8001,22984,10568,44536
RIBEIRÃO PRETO,ALTINÓPOLIS,755,1375,691,154,721,3696
RIBEIRÃO PRETO,BATATAIS,1394,730,3657,6557,3900,16238
RIBEIRÃO PRETO,CAJURU,855,544,928,1565,1464,5356
RIBEIRÃO PRETO,CÁSSIA DOS COQUEIROS,225,180,45,1,15,466
RIBEIRÃO PRETO,SANTA CRUZ DA ESPERANÇA,228,113,28,49,23,441
RIBEIRÃO PRETO,SANTO ANTÔNIO DA ALEGRIA,401,302,252,73,110,1138
ARAÇATUBA,ANDRADINA,1626,661,3515,5544,5254,16600
ARAÇATUBA,CASTILHO,842,251,487,1406,343,3329
ARAÇATUBA,GUARAÇAÍ,338,210,245,212,207,1212
ARAÇATUBA,ILHA SOLTEIRA,1073,126,1159,530,1830,4718
ARAÇATUBA,ITAPURA,282,84,44,51,224,685
ARAÇATUBA,MIRANDÓPOLIS,703,297,1065,902,826,3793
ARAÇATUBA,MURUTINGA DO SUL,248,72,77,13,28,438
ARAÇATUBA,NOVA INDEPENDÊNCIA,289,95,66,1181,54,1685
ARAÇATUBA,PEREIRA BARRETO,934,351,1214,2148,965,5612
ARAÇATUBA,SUD MENNUCCI,387,489,143,74,137,1230
ARAÇATUBA,SUZANÁPOLIS,282,76,73,1248,45,1724
ARAÇATUBA,ARAÇATUBA,3765,816,14684,10338,23201,52804
ARAÇATUBA,BENTO DE ABREU,219,49,11,587,156,1022
ARAÇATUBA,GUARARAPES,980,936,1263,2258,1190,6627
ARAÇATUBA,LAVÍNIA,323,168,109,0,62,662
ARAÇATUBA,RUBIÁCEA,176,115,36,8,172,507
ARAÇATUBA,SANTO ANTÔNIO DO ARACANGUÁ,579,486,84,223,92,1464
ARAÇATUBA,VALPARAÍSO,821,241,613,3369,898,5942
ARAÇATUBA,ALTO ALEGRE,206,72,91,32,65,466
ARAÇATUBA,AVANHANDAVA,337,55,270,1089,161,1912
ARAÇATUBA,BARBOSA,293,63,67,202,188,813
ARAÇATUBA,BILAC,255,62,424,495,317,1553
ARAÇATUBA,BIRIGUI,3032,507,7009,12740,6577,29865
ARAÇATUBA,BRAÚNA,185,63,110,80,48,486
ARAÇATUBA,BREJO ALEGRE,208,161,43,5,8,425
ARAÇATUBA,BURITAMA,628,123,694,830,613,2888
ARAÇATUBA,CLEMENTINA,323,43,142,515,177,1200
ARAÇATUBA,COROADOS,241,137,160,432,66,1036
ARAÇATUBA,GABRIEL MONTEIRO,220,119,114,444,51,948
ARAÇATUBA,GLICÉRIO,263,194,52,206,75,790
ARAÇATUBA,LOURDES,178,34,18,1,31,262
ARAÇATUBA,LUIZIÂNIA,234,150,96,15,83,578
ARAÇATUBA,PENÁPOLIS,1746,721,3739,4732,4592,15530
ARAÇATUBA,PIACATU,250,141,167,306,59,923
ARAÇATUBA,SANTÓPOLIS DO AGUAPEÍ,221,53,147,44,68,533
ARAÇATUBA,TURIÚBA,157,79,12,30,5,283
BAURU,CAFELÂNDIA,659,453,575,1908,495,4090
BAURU,GETULINA,318,686,140,31,153,1328
BAURU,GUAIÇARA,416,319,228,633,112,1708
BAURU,GUAIMBÊ,270,257,56,24,34,641
BAURU,JÚLIO MESQUITA,297,108,38,7,34,484
BAURU,LINS,1521,524,4319,10374,8897,25635
BAURU,PROMISSÃO,1192,1108,1534,3508,1408,8750
BAURU,SABINO,269,54,164,21,43,551
BAURU,AGUDOS,1579,903,1611,2606,2943,9642
BAURU,AREALVA,404,358,183,544,149,1638
BAURU,AREIÓPOLIS,372,592,256,111,135,1466
BAURU,AVAÍ,297,472,139,12,209,1129
BAURU,BALBINOS,252,20,6,40,1,319
BAURU,BAURU,6717,826,28717,31501,63712,131473
BAURU,BOREBI,208,263,28,103,8,610
BAURU,CABRÁLIA PAULISTA,190,348,135,217,77,967
BAURU,DUARTINA,410,213,509,543,477,2152
BAURU,GUARANTÃ,338,299,113,282,182,1214
BAURU,IACANGA,461,315,519,1416,266,2977
BAURU,LENÇÓIS PAULISTA,2015,1659,4300,12249,5549,25772
BAURU,LUCIANÓPOLIS,156,431,39,50,29,705
BAURU,PAULISTÂNIA,189,115,12,4,10,330
BAURU,PIRAJUÍ,497,1099,801,626,1057,4080
BAURU,PIRATININGA,311,299,411,323,720,2064
BAURU,PONGAÍ,238,35,99,92,61,525
BAURU,PRESIDENTE ALVES,214,128,56,45,31,474
BAURU,REGINÓPOLIS,292,947,154,73,67,1533
BAURU,UBIRAJARA,280,797,122,36,71,1306
BAURU,URU,203,47,10,10,8,278
BAURU,BARIRI,991,709,2038,3534,1560,8832
BAURU,BARRA BONITA,1004,202,2186,4836,2979,11207
BAURU,BOCAINA,471,239,302,2037,242,3291
BAURU,BORACÉIA,215,271,457,531,109,1583
BAURU,DOIS CÓRREGOS,813,598,1009,1572,1340,5332
BAURU,IGARAÇU DO TIETÊ,645,161,806,356,496,2464
BAURU,ITAJU,225,78,99,292,23,717
BAURU,ITAPUÍ,425,196,1471,2505,311,4908
BAURU,JAÚ,3188,885,10487,11048,12852,38460
BAURU,MACATUBA,496,714,589,1579,652,4030
BAURU,MINEIROS DO TIETÊ,387,146,248,467,306,1554
BAURU,PEDERNEIRAS,1346,1557,2323,6440,2501,14167
BAURU,ÁGUAS DE SANTA BÁRBARA,393,872,167,89,155,1676
BAURU,ARANDU,386,723,100,91,64,1364
BAURU,AVARÉ,2729,2087,6323,5113,5549,21801
BAURU,CERQUEIRA CÉSAR,873,935,878,1447,726,4859
BAURU,IARAS,781,790,107,56,90,1824
BAURU,ITAÍ,838,2494,892,450,803,5477
BAURU,ITATINGA,604,928,639,572,519,3262
BAURU,PARANAPANEMA,834,2054,1318,386,629,5221
BAURU,ANHEMBI,303,463,67,119,46,998
BAURU,BOFETE,431,604,270,181,821,2307
BAURU,BOTUCATU,2527,3118,8069,10929,17232,41875
BAURU,CONCHAS,553,384,555,708,730,2930
BAURU,PARDINHO,385,331,239,223,805,1983
BAURU,PRATÂNIA,234,510,118,88,308,1258
BAURU,SÃO MANUEL,970,769,1947,2678,1953,8317
ARARAQUARA,AMÉRICO BRASILIENSE,1323,32,868,5779,2525,10527
ARARAQUARA,ARARAQUARA,6458,839,15565,21649,32485,76996
ARARAQUARA,BOA ESPERANÇA DO SUL,672,1059,347,374,398,2850
ARARAQUARA,BORBOREMA,655,279,819,764,406,2923
ARARAQUARA,DOBRADA,324,40,114,272,64,814
ARARAQUARA,GAVIÃO PEIXOTO,313,809,72,2157,219,3570
ARARAQUARA,IBITINGA,1410,519,4137,7795,2218,16079
ARARAQUARA,ITÁPOLIS,1023,1468,2386,3265,1969,10111
ARARAQUARA,MATÃO,1585,7515,4435,12080,6180,31795
ARARAQUARA,MOTUCA,210,85,42,403,27,767
ARARAQUARA,NOVA EUROPA,475,208,212,2521,130,3546
ARARAQUARA,RINCÃO,367,375,166,265,321,1494
ARARAQUARA,SANTA LÚCIA,291,88,63,99,85,626
ARARAQUARA,TABATINGA,511,454,641,1072,272,2950
ARARAQUARA,TRABIJU,168,127,18,81,36,430
ARARAQUARA,ANALÂNDIA,288,776,192,239,82,1577
ARARAQUARA,DESCALVADO,1020,1255,1803,4226,2111,10415
ARARAQUARA,DOURADO,403,377,320,1451,726,3277
ARARAQUARA,IBATÉ,1046,677,1334,2859,751,6667
ARARAQUARA,RIBEIRÃO BONITO,382,472,330,269,374,1827
ARARAQUARA,SÃO CARLOS,4428,2837,15921,23169,33160,79515
PIRACICABA,BROTAS,774,1439,1380,1455,1949,6997
PIRACICABA,CORUMBATAÍ,270,232,313,227,143,1185
PIRACICABA,IPEÚNA,380,121,161,1100,173,1935
PIRACICABA,ITIRAPINA,803,1103,446,1511,3605,7468
PIRACICABA,RIO CLARO,5075,1145,11480,28416,20661,66777
PIRACICABA,TORRINHA,314,374,579,263,519,2049
PIRACICABA,ARARAS,3898,1365,7487,14118,11483,38351
PIRACICABA,CONCHAL,917,710,1400,2325,739,6091
PIRACICABA,CORDEIRÓPOLIS,1119,299,1751,5778,2015,10962
PIRACICABA,IRACEMÁPOLIS,668,133,1125,4006,1055,6987
PIRACICABA,LEME,3294,545,5633,8226,7294,24992
PIRACICABA,LIMEIRA,6603,888,18698,34840,26246,87275
PIRACICABA,SANTA CRUZ DA CONCEIÇÃO,260,256,110,542,92,1260
PIRACICABA,SANTA GERTRUDES,907,20,839,7211,1022,9999
PIRACICABA,ÁGUAS DE SÃO PEDRO,337,1,271,39,585,1233
PIRACICABA,CAPIVARI,1937,428,2853,6808,3123,15149
PIRACICABA,CHARQUEADA,484,248,426,811,446,2415
PIRACICABA,JUMIRIM,185,110,92,1105,44,1536
PIRACICABA,MOMBUCA,209,61,44,404,34,752
PIRACICABA,PIRACICABA,7646,1590,28877,46285,43726,128124
PIRACICABA,RAFARD,334,103,304,1512,315,2568
PIRACICABA,RIO DAS PEDRAS,841,143,1384,5568,1100,9036
PIRACICABA,SALTINHO,253,40,682,600,296,1871
PIRACICABA,SANTA MARIA DA SERRA,0,145,171,485,398,1199
PIRACICABA,SÃO PEDRO,992,466,1875,989,2339,6661
PIRACICABA,TIETÊ,1424,764,2394,7220,2509,14311
CAMPINAS,AGUAÍ,857,1180,1524,2262,1427,7250
CAMPINAS,PIRASSUNUNGA,4361,1265,4349,7078,6125,23178
CAMPINAS,PORTO FERREIRA,1500,407,4074,7474,3290,16745
CAMPINAS,SANTA CRUZ DAS PALMEIRAS,734,926,1314,419,1694,5087
CAMPINAS,ÁGUAS DA PRATA,269,152,168,189,232,1010
CAMPINAS,CACONDE,562,441,451,118,545,2117
CAMPINAS,CASA BRANCA,740,2194,1484,1099,1302,6819
CAMPINAS,DIVINOLÂNDIA,373,145,708,146,1060,2432
CAMPINAS,ESPÍRITO SANTO DO PINHAL,1100,1179,2004,5829,2545,12657
CAMPINAS,ITOBI,274,343,206,110,194,1127
CAMPINAS,MOCOCA,1396,2582,4471,5740,3460,17649
CAMPINAS,SANTO ANTÔNIO DO JARDIM,237,353,314,208,89,1201
CAMPINAS,SÃO JOÃO DA BOA VISTA,1871,1749,7095,5967,8363,25045
CAMPINAS,SÃO JOSÉ DO RIO PARDO,1473,1234,3777,4050,3870,14404
CAMPINAS,SÃO SEBASTIÃO DA GRAMA,386,977,642,425,399,2829
CAMPINAS,TAMBAÚ,660,860,1016,2797,751,6084
CAMPINAS,TAPIRATIBA,426,651,286,768,340,2471
CAMPINAS,VARGEM GRANDE DO SUL,917,563,2394,2295,1823,7992
CAMPINAS,ARTUR NOGUEIRA,1287,903,2380,3686,1792,10048
CAMPINAS,ENGENHEIRO COELHO,644,479,619,1375,1399,4516
CAMPINAS,ITAPIRA,2427,664,3684,11804,6172,24751
CAMPINAS,MOGI GUAÇU,3219,3517,8804,13323,12630,41493
CAMPINAS,MOGI MIRIM,3282,1860,6399,10809,7874,30224
CAMPINAS,SANTO ANTÔNIO DE POSSE,904,1341,2193,2389,1087,7914
CAMPINAS,ESTIVA GERBI,506,430,262,582,250,2030
CAMPINAS,AMERICANA,4527,197,16362,26543,27130,74759
CAMPINAS,CAMPINAS,21138,1473,86039,64987,237178,410815
CAMPINAS,COSMÓPOLIS,1779,70,1950,3576,2676,10051
CAMPINAS,ELIAS FAUSTO,641,256,536,3640,471,5544
CAMPINAS,HOLAMBRA,652,4613,1328,1624,3180,11397
CAMPINAS,HORTOLÂNDIA,4900,33,13962,17557,12612,49064
CAMPINAS,INDAIATUBA,5807,902,15441,33533,27736,83419
CAMPINAS,JAGUARIÚNA,2393,424,4064,13839,15717,36437
CAMPINAS,MONTE MOR,1672,570,2026,6033,3955,14256
CAMPINAS,NOVA ODESSA,1580,87,2919,12536,4273,21395
CAMPINAS,PAULÍNIA,4405,223,7886,16531,17004,46049
CAMPINAS,PEDREIRA,1239,106,2921,7418,2170,13854
CAMPINAS,SANTA BÁRBARA D'OESTE,4113,120,10187,19549,14707,48676
CAMPINAS,SUMARÉ,4095,504,14659,19707,19712,58677
CAMPINAS,VALINHOS,2906,357,9506,13472,19300,45541
CAMPINAS,VINHEDO,2836,70,6845,19745,11060,40556
CAMPINAS,ÁGUAS DE LINDÓIA,857,58,913,811,2450,5089
CAMPINAS,AMPARO,2031,1636,4166,12367,5021,25221
CAMPINAS,LINDÓIA,348,59,262,949,333,1951
CAMPINAS,MONTE ALEGRE DO SUL,360,95,246,350,335,1386
CAMPINAS,PEDRA BELA,281,255,261,60,70,927
CAMPINAS,PINHALZINHO,426,112,682,593,392,2205
CAMPINAS,SERRA NEGRA,877,348,1829,998,2128,6180
CAMPINAS,SOCORRO,1179,272,2110,2200,2296,8057
PRESIDENTE PRUDENTE,DRACENA,1370,205,3675,1786,5229,12265
PRESIDENTE PRUDENTE,JUNQUEIRÓPOLIS,689,217,1238,2026,1726,5896
PRESIDENTE PRUDENTE,MONTE CASTELO,185,185,58,12,48,488
PRESIDENTE PRUDENTE,NOVA GUATAPORANGA,185,13,24,1,6,229
PRESIDENTE PRUDENTE,OURO VERDE,324,75,117,49,51,616
PRESIDENTE PRUDENTE,PANORAMA,529,133,629,1106,489,2886
PRESIDENTE PRUDENTE,PAULICÉIA,359,43,244,1328,141,2115
PRESIDENTE PRUDENTE,SANTA MERCEDES,202,150,55,42,19,468
PRESIDENTE PRUDENTE,SÃO JOÃO DO PAU D'ALHO,159,8,26,29,22,244
PRESIDENTE PRUDENTE,TUPI PAULISTA,452,224,759,95,767,2297
PRESIDENTE PRUDENTE,ADAMANTINA,1065,878,2830,1801,3874,10448
PRESIDENTE PRUDENTE,FLORA RICA,187,48,8,1,7,251
PRESIDENTE PRUDENTE,FLÓRIDA PAULISTA,414,218,334,246,212,1424
PRESIDENTE PRUDENTE,INÚBIA PAULISTA,216,134,370,133,113,966
PRESIDENTE PRUDENTE,IRAPURU,421,46,132,20,93,712
PRESIDENTE PRUDENTE,LUCÉLIA,748,178,811,1447,7249,10433
PRESIDENTE PRUDENTE,MARIÁPOLIS,193,86,29,5,20,333
PRESIDENTE PRUDENTE,OSVALDO CRUZ,943,193,1842,2291,2422,7691
PRESIDENTE PRUDENTE,PACAEMBU,454,205,389,48,277,1373
PRESIDENTE PRUDENTE,PARAPUÃ,359,422,451,1409,320,2961
PRESIDENTE PRUDENTE,PRACINHA,208,14,41,14,16,293
PRESIDENTE PRUDENTE,RINÓPOLIS,291,484,209,417,416,1817
PRESIDENTE PRUDENTE,SAGRES,196,28,33,63,30,350
PRESIDENTE PRUDENTE,SALMOURÃO,227,126,53,4,169,579
PRESIDENTE PRUDENTE,ALFREDO MARCONDES,222,54,70,706,137,1189
PRESIDENTE PRUDENTE,ÁLVARES MACHADO,623,145,939,1044,764,3515
PRESIDENTE PRUDENTE,ANHUMAS,262,99,41,49,27,478
PRESIDENTE PRUDENTE,CAIABU,264,28,36,17,19,364
PRESIDENTE PRUDENTE,CAIUÁ,324,138,41,6,16,525
PRESIDENTE PRUDENTE,EMILIANÓPOLIS,208,65,40,39,20,372
PRESIDENTE PRUDENTE,ESTRELA DO NORTE,228,41,28,7,49,353
PRESIDENTE PRUDENTE,EUCLIDES DA CUNHA PAULISTA,428,96,116,30,35,705
PRESIDENTE PRUDENTE,INDIANA,227,50,102,232,77,688
PRESIDENTE PRUDENTE,JOÃO RAMALHO,202,94,58,3,56,413
PRESIDENTE PRUDENTE,MARABÁ PAULISTA,302,189,34,40,8,573
PRESIDENTE PRUDENTE,MARTINÓPOLIS,991,271,711,417,653,3043
PRESIDENTE PRUDENTE,MIRANTE DO PARANAPANEMA,749,216,344,1667,647,3623
PRESIDENTE PRUDENTE,NARANDIBA,436,84,101,2797,108,3526
PRESIDENTE PRUDENTE,PIQUEROBI,253,164,52,80,16,565
PRESIDENTE PRUDENTE,PIRAPOZINHO,946,168,1008,1525,1547,5194
PRESIDENTE PRUDENTE,PRESIDENTE BERNARDES,564,383,614,168,440,2169
PRESIDENTE PRUDENTE,PRESIDENTE EPITÁCIO,1273,269,1914,844,1550,5850
PRESIDENTE PRUDENTE,PRESIDENTE PRUDENTE,5285,464,17489,13384,28713,65335
PRESIDENTE PRUDENTE,PRESIDENTE VENCESLAU,983,280,1977,504,2278,6022
PRESIDENTE PRUDENTE,RANCHARIA,993,1586,1222,1744,1392,6937
PRESIDENTE PRUDENTE,REGENTE FEIJÓ,817,311,1718,1268,858,4972
PRESIDENTE PRUDENTE,RIBEIRÃO DOS ÍNDIOS,206,22,31,23,3,285
PRESIDENTE PRUDENTE,ROSANA,786,148,481,248,732,2395
PRESIDENTE PRUDENTE,SANDOVALINA,388,88,64,1224,35,1799
PRESIDENTE PRUDENTE,SANTO ANASTÁCIO,552,355,810,549,1021,3287
PRESIDENTE PRUDENTE,SANTO EXPEDITO,237,19,36,14,24,330
PRESIDENTE PRUDENTE,TACIBA,450,107,109,63,80,809
PRESIDENTE PRUDENTE,TARABAI,351,83,175,246,153,1008
PRESIDENTE PRUDENTE,TEODORO SAMPAIO,846,376,660,610,791,3283
MARÍLIA,ARCO-ÍRIS,188,73,8,39,11,319
MARÍLIA,BASTOS,901,2690,1053,1378,848,6870
MARÍLIA,HERCULÂNDIA,331,407,271,294,144,1447
MARÍLIA,IACRI,209,240,254,247,81,1031
MARÍLIA,QUEIROZ,345,312,70,1750,20,2497
MARÍLIA,QUINTANA,294,266,227,481,198,1466
MARÍLIA,TUPÃ,2302,1180,4493,3006,4907,15888
MARÍLIA,ÁLVARO DE CARVALHO,194,87,36,3,28,348
MARÍLIA,ALVINLÂNDIA,177,78,31,19,7,312
MARÍLIA,ECHAPORÃ,264,192,200,111,207,974
MARÍLIA,FERNÃO,157,96,46,30,3,332
MARÍLIA,GÁLIA,302,285,169,418,149,1323
MARÍLIA,GARÇA,1340,1134,2483,2958,4583,12498
MARÍLIA,LUPÉRCIO,203,174,58,136,21,592
MARÍLIA,MARÍLIA,5405,859,15406,16525,32677,70872
MARÍLIA,OCAUÇU,241,456,97,73,47,914
MARÍLIA,ORIENTE,266,97,93,270,168,894
MARÍLIA,OSCAR BRESSANE,229,72,45,81,15,442
MARÍLIA,POMPÉIA,782,301,1004,4684,1614,8385
MARÍLIA,VERA CRUZ,329,266,322,80,241,1238
ASSIS,ASSIS,2722,291,7910,3482,8343,22748
ASSIS,BORÁ,118,21,7,733,16,895
ASSIS,CAMPOS NOVOS PAULISTA,259,285,108,113,60,825
ASSIS,CÂNDIDO MOTA,843,372,1754,2292,1175,6436
ASSIS,CRUZÁLIA,190,70,76,59,22,417
ASSIS,FLORÍNIA,254,122,77,1,14,468
ASSIS,IBIRAREMA,228,81,151,328,131,919
ASSIS,IEPÊ,453,168,274,72,159,1126
ASSIS,LUTÉCIA,246,98,31,46,6,427
ASSIS,MARACAÍ,528,297,413,493,863,2594
ASSIS,NANTES,222,127,41,50,16,456
ASSIS,PALMITAL,665,435,1251,924,1003,4278
ASSIS,PARAGUAÇU PAULISTA,1525,2011,1688,3241,2098,10563
ASSIS,PEDRINHAS PAULISTA,284,61,196,191,27,759
ASSIS,PLATINA,210,191,29,69,26,525
ASSIS,QUATÁ,593,230,398,1935,644,3800
ASSIS,TARUMÃ,672,1783,702,1830,288,5275
ASSIS,BERNARDINO DE CAMPOS,390,296,325,1127,526,2664
ASSIS,CANITAR,303,17,38,157,14,529
ASSIS,ESPÍRITO SANTO DO TURVO,250,234,73,6,21,584
ASSIS,FARTURA,620,446,605,1356,783,3810
ASSIS,IPAUSSU,570,170,506,1649,542,3437
ASSIS,MANDURI,395,766,301,383,180,2025
ASSIS,ÓLEO,163,118,15,15,11,322
ASSIS,OURINHOS,2955,1973,7337,6556,9362,28183
ASSIS,PIRAJU,914,549,1756,1685,1687,6591
ASSIS,RIBEIRÃO DO SUL,230,96,140,95,52,613
ASSIS,SALTO GRANDE,394,187,294,412,202,1489
ASSIS,SANTA CRUZ DO RIO PARDO,1240,3456,3348,4325,3422,15791
ASSIS,SÃO PEDRO DO TURVO,345,813,138,227,64,1587
ASSIS,SARUTAIÁ,224,56,34,253,54,621
ASSIS,TAGUAÍ,524,240,532,3026,310,4632
ASSIS,TEJUPÁ,233,188,31,317,73,842
ASSIS,TIMBURI,184,163,47,3,15,412
ASSIS,CHAVANTES,447,167,328,599,304,1845
ITAPETININGA,BARÃO DE ANTONINA,196,41,59,263,13,572
ITAPETININGA,BOM SUCESSO DE ITARARÉ,248,84,95,83,70,580
ITAPETININGA,BURI,863,2154,831,503,510,4861
ITAPETININGA,CORONEL MACEDO,270,176,50,299,24,819
ITAPETININGA,ITABERÁ,637,966,675,512,261,3051
ITAPETININGA,ITAPEVA,3292,3831,5588,2299,6113,21123
ITAPETININGA,ITAPORANGA,617,187,572,420,399,2195
ITAPETININGA,ITARARÉ,1614,572,2896,1282,1914,8278
ITAPETININGA,NOVA CAMPINA,438,343,220,938,86,2025
ITAPETININGA,RIVERSUL,240,113,98,117,42,610
ITAPETININGA,TAQUARITUBA,802,597,1507,972,1047,4925
ITAPETININGA,TAQUARIVAÍ,355,531,347,126,65,1424
ITAPETININGA,ALAMBARI,289,252,133,211,85,970
ITAPETININGA,ANGATUBA,862,1883,887,1053,695,5380
ITAPETININGA,CAMPINA DO MONTE ALEGRE,255,186,116,118,79,754
ITAPETININGA,GUAREÍ,568,732,296,737,200,2533
ITAPETININGA,ITAPETININGA,3841,5658,9513,9932,9675,38619
ITAPETININGA,BOITUVA,1966,473,3532,11294,4022,21287
ITAPETININGA,CERQUILHO,1117,954,2364,6735,2280,13450
ITAPETININGA,CESÁRIO LANGE,559,395,837,1226,2762,5779
ITAPETININGA,LARANJAL PAULISTA,863,198,1435,5167,2113,9776
ITAPETININGA,PEREIRAS,292,364,242,1283,218,2399
ITAPETININGA,PORANGABA,367,266,279,139,344,1395
ITAPETININGA,QUADRA,225,173,55,7,108,568
ITAPETININGA,TATUÍ,3624,1464,6574,9714,9233,30609
ITAPETININGA,TORRE DE PEDRA,165,26,37,4,12,244
ITAPETININGA,APIAÍ,803,1172,1091,1217,905,5188
ITAPETININGA,BARRA DO CHAPÉU,219,460,48,16,15,758
ITAPETININGA,CAPÃO BONITO,1608,2185,2206,1067,1728,8794
ITAPETININGA,GUAPIARA,16,348,436,328,126,1254
ITAPETININGA,IPORANGA,314,33,46,32,54,479
ITAPETININGA,ITAÓCA,198,10,49,70,4,331
ITAPETININGA,ITAPIRAPUÃ PAULISTA,203,345,91,9,25,673
ITAPETININGA,RIBEIRA,178,204,96,78,28,584
ITAPETININGA,RIBEIRÃO BRANCO,643,1755,707,169,265,3539
ITAPETININGA,RIBEIRÃO GRANDE,325,98,80,75,45,623
MACRO METROPOLITANA PAULISTA,IBIÚNA,1970,3221,3895,3092,2856,15034
MACRO METROPOLITANA PAULISTA,PIEDADE,1173,1561,2500,1627,1716,8577
MACRO METROPOLITANA PAULISTA,PILAR DO SUL,833,1116,2166,593,1431,6139
MACRO METROPOLITANA PAULISTA,SÃO MIGUEL ARCANJO,783,1329,1461,480,800,4853
MACRO METROPOLITANA PAULISTA,TAPIRAÍ,312,183,201,309,148,1153
MACRO METROPOLITANA PAULISTA,ALUMÍNIO,746,18,431,5078,493,6766
MACRO METROPOLITANA PAULISTA,ARAÇARIGUAMA,906,41,1936,4518,3478,10879
MACRO METROPOLITANA PAULISTA,ARAÇOIABA DA SERRA,1175,477,1071,2165,1564,6452
MACRO METROPOLITANA PAULISTA,CABREÚVA,1569,553,2815,8224,2841,16002
MACRO METROPOLITANA PAULISTA,CAPELA DO ALTO,701,1300,839,572,488,3900
MACRO METROPOLITANA PAULISTA,IPERÓ,1302,71,904,3161,3197,8635
MACRO METROPOLITANA PAULISTA,ITU,4635,1213,11574,18723,19430,55575
MACRO METROPOLITANA PAULISTA,MAIRINQUE,1431,245,1998,3236,4466,11376
MACRO METROPOLITANA PAULISTA,PORTO FELIZ,1858,1594,2652,6975,3607,16686
MACRO METROPOLITANA PAULISTA,SALTO,2738,220,6397,12652,9643,31650
MACRO METROPOLITANA PAULISTA,SALTO DE PIRAPORA,1141,190,1350,2595,1235,6511
MACRO METROPOLITANA PAULISTA,SÃO ROQUE,2417,660,6411,5253,6926,21667
MACRO METROPOLITANA PAULISTA,SARAPUÍ,384,279,264,1068,150,2145
MACRO METROPOLITANA PAULISTA,SOROCABA,10750,391,45968,62777,85446,205332
MACRO METROPOLITANA PAULISTA,VOTORANTIM,2438,40,5726,5988,5868,20060
MACRO METROPOLITANA PAULISTA,CAMPO LIMPO PAULISTA,2105,119,2423,5052,2830,12529
MACRO METROPOLITANA PAULISTA,ITUPEVA,2128,242,5711,12849,8343,29273
MACRO METROPOLITANA PAULISTA,JUNDIAÍ,7965,407,38033,50817,80168,177390
MACRO METROPOLITANA PAULISTA,LOUVEIRA,1660,184,2738,5775,7763,18120
MACRO METROPOLITANA PAULISTA,VÁRZEA PAULISTA,1743,7,4078,8453,4444,18725
MACRO METROPOLITANA PAULISTA,ATIBAIA,3237,1601,9898,12240,15243,42219
MACRO METROPOLITANA PAULISTA,BOM JESUS DOS PERDÕES,760,45,1019,3282,794,5900
MACRO METROPOLITANA PAULISTA,BRAGANÇA PAULISTA,3922,1468,10374,14559,15790,46113
MACRO METROPOLITANA PAULISTA,ITATIBA,2831,522,5684,15101,11225,35363
MACRO METROPOLITANA PAULISTA,JARINU,1207,305,2340,3151,1774,8777
MACRO METROPOLITANA PAULISTA,JOANÓPOLIS,10,211,694,615,507,2037
MACRO METROPOLITANA PAULISTA,MORUNGABA,489,246,446,2348,1184,4713
MACRO METROPOLITANA PAULISTA,NAZARÉ PAULISTA,582,79,434,933,1000,3028
MACRO METROPOLITANA PAULISTA,PIRACAIA,870,226,1022,1560,999,4677
MACRO METROPOLITANA PAULISTA,TUIUTI,257,144,59,67,56,583
MACRO METROPOLITANA PAULISTA,VARGEM,271,90,191,177,246,975
VALE DO PARAÍBA PAULISTA,CAMPOS DO JORDÃO,1843,21,2930,1071,6995,12860
VALE DO PARAÍBA PAULISTA,MONTEIRO LOBATO,207,70,97,108,145,627
VALE DO PARAÍBA PAULISTA,SANTO ANTÔNIO DO PINHAL,354,129,243,43,397,1166
VALE DO PARAÍBA PAULISTA,SÃO BENTO DO SAPUCAÍ,471,156,465,124,1268,2484
VALE DO PARAÍBA PAULISTA,CAÇAPAVA,1980,339,4258,9963,5866,22406
VALE DO PARAÍBA PAULISTA,IGARATÁ,590,93,195,359,318,1555
VALE DO PARAÍBA PAULISTA,JACAREÍ,4427,869,10041,15169,20010,50516
VALE DO PARAÍBA PAULISTA,PINDAMONHANGABA,3329,645,6990,11937,9742,32643
VALE DO PARAÍBA PAULISTA,SANTA BRANCA,641,319,353,487,481,2281
VALE DO PARAÍBA PAULISTA,SÃO JOSÉ DOS CAMPOS,13771,462,39909,38404,91927,184473
VALE DO PARAÍBA PAULISTA,TAUBATÉ,7924,476,17203,20352,33007,78962
VALE DO PARAÍBA PAULISTA,TREMEMBÉ,1187,173,1341,1371,1019,5091
VALE DO PARAÍBA PAULISTA,APARECIDA,1172,67,2395,729,5854,10217
VALE DO PARAÍBA PAULISTA,CACHOEIRA PAULISTA,995,185,903,608,2355,5046
VALE DO PARAÍBA PAULISTA,CANAS,314,22,210,402,149,1097
VALE DO PARAÍBA PAULISTA,CRUZEIRO,2256,111,3359,8567,4068,18361
VALE DO PARAÍBA PAULISTA,GUARATINGUETÁ,5020,506,7101,7556,9487,29670
VALE DO PARAÍBA PAULISTA,LAVRINHAS,382,73,76,196,133,860
VALE DO PARAÍBA PAULISTA,LORENA,2042,320,3644,6004,6087,18097
VALE DO PARAÍBA PAULISTA,PIQUETE,333,72,225,898,182,1710
VALE DO PARAÍBA PAULISTA,POTIM,602,41,285,315,149,1392
VALE DO PARAÍBA PAULISTA,QUELUZ,469,135,328,269,527,1728
VALE DO PARAÍBA PAULISTA,ROSEIRA,404,69,408,872,630,2383
VALE DO PARAÍBA PAULISTA,ARAPEÍ,246,60,47,3,13,369
VALE DO PARAÍBA PAULISTA,AREIAS,294,169,37,9,100,609
VALE DO PARAÍBA PAULISTA,BANANAL,485,228,196,480,267,1656
VALE DO PARAÍBA PAULISTA,SÃO JOSÉ DO BARREIRO,258,131,38,45,34,506
VALE DO PARAÍBA PAULISTA,SILVEIRAS,372,156,156,29,21,734
VALE DO PARAÍBA PAULISTA,CUNHA,627,435,523,204,488,2277
VALE DO PARAÍBA PAULISTA,JAMBEIRO,477,177,170,2536,272,3632
VALE DO PARAÍBA PAULISTA,LAGOINHA,217,137,118,49,133,654
VALE DO PARAÍBA PAULISTA,NATIVIDADE DA SERRA,328,219,89,32,56,724
VALE DO PARAÍBA PAULISTA,PARAIBUNA,792,344,512,404,605,2657
VALE DO PARAÍBA PAULISTA,REDENÇÃO DA SERRA,215,170,58,32,99,574
VALE DO PARAÍBA PAULISTA,SÃO LUÍS DO PARAITINGA,508,330,395,192,335,1760
VALE DO PARAÍBA PAULISTA,CARAGUATATUBA,4755,110,8593,3497,10121,27076
VALE DO PARAÍBA PAULISTA,ILHABELA,1942,10,2310,325,5081,9668
VALE DO PARAÍBA PAULISTA,SÃO SEBASTIÃO,3415,9,4143,2316,10498,20381
VALE DO PARAÍBA PAULISTA,UBATUBA,2283,34,5876,1892,9964,20049
LITORAL SUL PAULISTA,BARRA DO TURVO,416,48,143,45,59,711
LITORAL SUL PAULISTA,CAJATI,1027,831,955,2351,1805,6969
LITORAL SUL PAULISTA,CANANÉIA,652,95,276,76,531,1630
LITORAL SUL PAULISTA,ELDORADO,622,977,224,122,193,2138
LITORAL SUL PAULISTA,IGUAPE,1116,192,816,190,461,2775
LITORAL SUL PAULISTA,ILHA COMPRIDA,819,,548,48,185,1600
LITORAL SUL PAULISTA,JACUPIRANGA,647,897,672,342,830,3388
LITORAL SUL PAULISTA,JUQUIÁ,743,294,464,257,336,2094
LITORAL SUL PAULISTA,MIRACATU,640,475,536,294,921,2866
LITORAL SUL PAULISTA,PARIQUERA-AÇU,1531,719,718,338,1135,4441
LITORAL SUL PAULISTA,REGISTRO,1858,1084,3744,1442,5765,13893
LITORAL SUL PAULISTA,SETE BARRAS,346,911,262,215,125,1859
LITORAL SUL PAULISTA,ITANHAÉM,4134,80,4971,809,4453,14447
LITORAL SUL PAULISTA,ITARIRI,435,266,470,102,428,1701
LITORAL SUL PAULISTA,MONGAGUÁ,1847,1,2016,909,2263,7036
LITORAL SUL PAULISTA,PEDRO DE TOLEDO,403,112,284,34,91,924
LITORAL SUL PAULISTA,PERUÍBE,2024,33,3738,862,3333,9990
METROPOLITANA DE SÃO PAULO,BARUERI,13729,52,46659,40393,218155,318988
METROPOLITANA DE SÃO PAULO,CAJAMAR,2639,23,9701,13794,24640,50797
METROPOLITANA DE SÃO PAULO,CARAPICUÍBA,5127,66,11063,6678,11773,34707
METROPOLITANA DE SÃO PAULO,ITAPEVI,4527,21,9373,11776,10817,36514
METROPOLITANA DE SÃO PAULO,JANDIRA,3154,0,4769,7942,5055,20920
METROPOLITANA DE SÃO PAULO,OSASCO,16444,11,46176,22713,97185,182529
METROPOLITANA DE SÃO PAULO,PIRAPORA DO BOM JESUS,1048,15,302,849,338,2552
METROPOLITANA DE SÃO PAULO,SANTANA DE PARNAÍBA,8462,57,7996,16090,24299,56904
METROPOLITANA DE SÃO PAULO,CAIEIRAS,2337,35,3997,8913,6580,21862
METROPOLITANA DE SÃO PAULO,FRANCISCO MORATO,2170,0,2962,667,4164,9963
METROPOLITANA DE SÃO PAULO,FRANCO DA ROCHA,3726,47,4617,4181,4532,17103
METROPOLITANA DE SÃO PAULO,MAIRIPORÃ,2224,25,3624,4758,5181,15812
METROPOLITANA DE SÃO PAULO,ARUJÁ,2126,134,6543,10884,7183,26870
METROPOLITANA DE SÃO PAULO,GUARULHOS,21100,76,76172,102383,142629,342360
METROPOLITANA DE SÃO PAULO,SANTA ISABEL,1290,316,2244,3256,3204,10310
METROPOLITANA DE SÃO PAULO,COTIA,5384,350,18863,25359,30754,80710
METROPOLITANA DE SÃO PAULO,EMBU DAS ARTES,4243,34,11443,11330,17383,44433
METROPOLITANA DE SÃO PAULO,EMBU-GUAÇU,35,141,2013,3125,2755,8069
METROPOLITANA DE SÃO PAULO,ITAPECERICA DA SERRA,3416,181,6755,3879,9405,23636
METROPOLITANA DE SÃO PAULO,JUQUITIBA,919,54,1246,597,1718,4534
METROPOLITANA DE SÃO PAULO,SÃO LOURENÇO DA SERRA,616,70,374,566,4550,6176
METROPOLITANA DE SÃO PAULO,TABOÃO DA SERRA,6471,4,11899,17960,27809,64143
METROPOLITANA DE SÃO PAULO,VARGEM GRANDE PAULISTA,1297,166,3371,5658,2626,13118
METROPOLITANA DE SÃO PAULO,DIADEMA,6846,0,19049,41444,22113,89452
METROPOLITANA DE SÃO PAULO,MAUÁ,6385,3,15418,23153,23444,68403
METROPOLITANA DE SÃO PAULO,RIBEIRÃO PIRES,3210,0,5156,7875,5418,21659
METROPOLITANA DE SÃO PAULO,RIO GRANDE DA SERRA,891,7,653,1334,537,3422
METROPOLITANA DE SÃO PAULO,SANTO ANDRÉ,10152,12,41293,35863,115954,203274
METROPOLITANA DE SÃO PAULO,SÃO BERNARDO DO CAMPO,13295,80,48387,78037,122894,262693
METROPOLITANA DE SÃO PAULO,SÃO CAETANO DO SUL,5997,4,16405,26457,56049,104912
METROPOLITANA DE SÃO PAULO,SÃO PAULO,742545,2690,831791,624704,2874840,5076570
METROPOLITANA DE SÃO PAULO,BIRITIBA-MIRIM,736,759,1038,286,531,3350
METROPOLITANA DE SÃO PAULO,FERRAZ DE VASCONCELOS,2724,6,4890,9655,2812,20087
METROPOLITANA DE SÃO PAULO,GUARAREMA,826,318,1123,3039,2146,7452
METROPOLITANA DE SÃO PAULO,ITAQUAQUECETUBA,5065,47,11889,19933,11115,48049
METROPOLITANA DE SÃO PAULO,MOGI DAS CRUZES,5739,1648,21702,24071,49930,103090
METROPOLITANA DE SÃO PAULO,POÁ,2413,3,4211,6263,12199,25089
METROPOLITANA DE SÃO PAULO,SALESÓPOLIS,421,565,563,61,441,2051
METROPOLITANA DE SÃO PAULO,SUZANO,5217,533,12950,18872,32058,69630
METROPOLITANA DE SÃO PAULO,BERTIOGA,1587,27,3978,804,7759,14155
METROPOLITANA DE SÃO PAULO,CUBATÃO,3683,4,3149,10947,9985,27768
METROPOLITANA DE SÃO PAULO,GUARUJÁ,6798,204,12230,2921,26391,48544
METROPOLITANA DE SÃO PAULO,PRAIA GRANDE,11749,2,16334,6136,19438,53659
METROPOLITANA DE SÃO PAULO,SANTOS,13735,268,28384,15444,115094,172925
METROPOLITANA DE SÃO PAULO,SÃO VICENTE,6724,6,10538,2548,15359,35175
